XXXXXXXXXXXXXXX
X....X........X
..X..X.XX.XXXXX
X.XXXX..X.....X
X....XXXXXXXX.X
XX.XXX.....X..X
X..X..XX.XXX.XX
X.XXX.X....X..X
X...X.XXXX.XX.X
X.X...........X
X.X.XXXXXXX.XXX
X.X......X.....
X.XXXXXXXX.XXXX
X.X...........X
XXXXXXXXXXXXXXX
