XXXXXXXXXXXXXXX
X...X..XX.....X
....X...X.XXXXX
X..XXX..X.....X
XX......XXXX..X
X..XX......X..X
X...X.XXXXXX.XX
X...X.X....X..X
X.X.X.X....X..X
X.X...........X
XXX.XXXXXX..XXX
X.X......X.....
X.XXXXXXXX..XXX
X.............X
XXXXXXXXXXXXXXX
